

2 2                                                         2 2 
2 2                                                         2 2 
2 2                                                         2 2 
                                                            2 2 
                                                            2 2 
1 1 1 1 1 1 1 1 1 1 1 1 1 1       2 1 1 1 1 1 1 1 1 1 1 1 1 2 2 
2                                 2                         2 2 
2                                 2                         2 2 
2                                 2                         2 2 
2                                 2                         2 2 
2                                 2                         2 2 
2                                 2                         2 2 
2                                 2                         2 2 
            1 1 1                                           2 2 
                                                            2 2 
1 1 1 1 1 1 1 1 1 1 1 1 1 1 1 1 1 1 1 1 1 1 1 1 1 1 1 1 1 1 2 2 



116 0 116 116 116 0 116 116 116 0 116 116 116 0 116 116 116 0 116 116 116 0 116 116 116 0 116 116 116 0 116 116 116 0 116 116 116 0 116 116 32 32 32 116 32 0 0 116 32 0 32 32 116 0 116 116 32 116 116 0 32 0 116 32 32 64 32 116 32 0 0 116 32 64 116 0 32 0 64 64 32 0 64 64 32 0 64 32 116 0 116 116 116 0 116 116 116 0 116 116 116 0 116 116 116 0 116 116 116 0 116 116 116 0 116 116 116 0 116 116 116 0 116 116 116 0 116 116 116 116 116 116 116 116 116 116 116 116 116 116 116 116 116 116 116 116 116 116 116 116 116 116 116 116 116 116 116 116 116 116 116 116 116 116 116 32 32 0 116 116 116 116 32 116 116 116 116 116 0 32 32 0 32 116 0 32 116 0 116 0 64 32 0 32 32 0 64 64 64 64 116 116 64 0 116 32 64 64 0 0 0 0 116 116 116 116 32 32 32 32 64 64 0 116 32 32 32 32 116 116 116 116 0 0 0 0 64 64 64 64 116 116 116 116 116 116 116 116 116 116 116 116 116 116 116 116 116 116 116 116 116 116 116 116 116 116 116 116 116 116 116 116 116 116 32 64 116 116 116 64 116 116 116 116 116 116 64 116 116 116 116 116 116 64 116 116 116 116 116 116 64 116 116 116 116 116 116 116 116 64 64 32 0 0 32 32 116 116 116 116 116 116 116 116 116 116 116 116 116 116 116 116 116 116 116 116 116 116 116 116 64 64 64 64 116 116 116 116 64 32 32 116 32 32 64 64 116 116 32 116 116 116 116 32 0 116 0 32 32 32 64 64 116 116 0 116 116 116 116 0 116 116 116 116 116 116 116 116 116 32 64 64 116 116 32 116 116 116 0 0 32 64 32 64 0 116 32 64 0 64 116 32 0 0 0 0 116 116 0 0 116 0 116 0 116 0 116 116 116 0 32 64 116 32 0 64 116 116 116 116 116 116 116 116 116 116 116 116 116 64 0 64 116 32 116 116 64 64 64 64 116 116 116 116 116 116 116 116 116 116 116 116 116 116 116 116 116 116 116 116 116 116 116 116 116 116 116 116 116 116 116 116 116 116 116 116 116 116 116 116 116 116 116 116 116 116 116 116 116 116 116 116 


0 0 160 160 160 160 160 160 160 160 160 160 160 160 160 160 160 160 160 160 160 160 160 160 160 160 160 160 160 160 0 0
0 0 160 160 160 160 160 160 160 160 160 160 160 160 160 160 160 160 160 160 160 160 160 160 160 160 160 160 160 160 0 0 
0 0 160 160 160 160 160 160 160 160 160 160 160 160 160 160 160 160 160 160 160 160 160 160 160 160 160 160 160 160 0 0 
160 160 160 160 160 160 160 160 160 160 160 160 160 160 160 160 160 160 160 160 160 160 160 160 160 160 160 160 160 160 0 0 
160 160 160 160 160 160 160 160 160 160 160 160 160 160 160 160 160 160 160 160 160 160 160 160 160 160 160 160 160 160 0 0 
0 0 0 0 0 0 0 0 0 0 0 0 0 0 160 160 160 0 0 0 0 0 0 0 0 0 0 0 0 0 0 0 0 160 160 160 160 160 160 160 160 160 160 160 160 160 160 160 160 0 160 160 160 160 160 160 160 160 160 160 160 160 0 0 0 160 160 160 160 160 160 160 160 160 160 160 160 160 160 160 160 0 160 160 160 160 160 160 160 160 160 160 160 160 0 0 0 160 160 160 160 160 160 160 160 160 160 160 160 160 160 160 160 0 160 160 160 160 160 160 160 160 160 160 160 160 0 0 0 160 160 160 160 160 160 160 160 160 160 160 160 160 160 160 160 0 160 160 160 160 160 160 160 160 160 160 160 160 0 0 0 160 160 160 160 160 160 160 160 160 160 160 160 160 160 160 160 0 160 160 160 160 160 160 160 160 160 160 160 160 0 0 0 160 160 160 160 160 160 160 160 160 160 160 160 160 160 160 160 0 160 160 160 160 160 160 160 160 160 160 160 160 0 0 0 160 160 160 160 160 160 160 160 160 160 160 160 160 160 160 160 0 160 160 160 160 160 160 160 160 160 160 160 160 0 0 160 160 160 160 160 160 0 0 0 160 160 160 160 160 160 160 160 160 160 160 160 160 160 160 160 160 160 160 160 160 0 0 160 160 160 160 160 160 160 160 160 160 160 160 160 160 160 160 160 160 160 160 160 160 160 160 160 160 160 160 160 160 0 0 0 0 0 0 0 0 0 0 0 0 0 0 0 0 0 0 0 0 0 0 0 0 0 0 0 0 0 0 0 0 0 0 









a0 00 00 00 00 00 00 0a a0 00 00 00 00 00 00 0a 
a0 00 00 00 00 00 00 0a 00 00 00 00 00 00 00 0a 
00 00 00 00 00 00 00 0a 55 55 55 50 25 55 55 5a 
80 00 00 00 20 00 00 0a 80 00 00 00 20 00 00 0a 
80 00 00 00 20 00 00 0a 80 00 00 00 20 00 00 0a 
80 00 00 00 20 00 00 0a 80 00 00 00 20 00 00 0a 
80 00 00 00 20 00 00 0a 00 05 40 00 00 00 00 0a 
00 00 00 00 00 00 00 0a 55 55 55 55 55 55 55 5a 
name:
20 20 20 20 20 20 20 20 20 20 54 68 65 20 42 61 
74 68 72 6f 6f 6d 20 20 20 20 20 20 20 20 20 20 

Back:
00 00 00 00 00 00 00 00 00 
16 00 40 09 64 92 2d 96 ff 
0e 1f aa 00 55 f8 55 00 aa 
ff 00 00 00 00 00 00 00 00 
07 03 00 0c 00 30 00 c0 00 3d a5 00 00 00 00 00 00 ff 00 d4 5f 04 01 89 5f 08 02 00 00 1f 04 0a 77 87 b1 aa 0a 22 20 27 1b 00 00 00 3b 10 ff 00 00 00 00 00 00 00 00 00 00 00 00 00 


Guardian data for romm: 3b 10 ff 00 00 00 00 00  00 00 00 00 00 00 00 00

Guardians:

01 64 10 00 30 00 b9 00 
ff 00 00 00 00 00 00 00 
00 00 00 00 00 00 00 00 
00 00 00 00 00 00 00 00 
00 00 00 00 00 00 00 00 
00 00 00 00 00 00 00 00 
00 00 00 00 00 00 00 00 
00 00 00 00 00 00 00 00 
ff fb

Correct value for guardians:
41 64 07 30 00 b9 00 1b        Type 41, attribute 64, X==7, Y==0x30, b9 address high byte
ff 00 00 00 00 00 00 ad
00 00 00 00 00 00 00 00  
00 00 00 00 00 00 00 00
00 00 00 00 00 00 00 00  
00 00 00 00 00 00 00 00
00 00 00 00 00 00 00 00  
00 00 00 00 00 00 00 00
ff

ROM guardian data for 0x3b: 
    01 64 10 30 00 b9 00 1b













FRAME: 2
New ypos: 9d Gptr 4 fb Gptr 6 50 Gptr 7 a0
UpdateG: 04
UpdateG: ff
done
Slope PSN: 34 5f
Guardian: c1
Sprite at 0x0000bcc0
Guardian: ea
Guardian 3 lines
Sprite at 0x0000ab60
Guardian: 04
Sprite at 0x00000080
Guardian: ff
Done draw room?
UpdateG: c1
FRAME: 2
UpdateG: ea
Vertical
FRAME: 3
New ypos: a1 Gptr 4 04 Gptr 6 50 Gptr 7 a0
UpdateG: 04











Read Willy sprite 00005db4
1b4 offset == col 20, line 13

-- should be 3348

20 + (13*256);
      
      line off is 3328
      1b4h<<3 == 3488
      

PLB offset 3476
